0000000000000000000000000000000000000000000000000000000000000000000000000000000000000000000000000
0000000000000000000000000000000000000000000000000000000000000000000000000000000000000000000000000
0000000000000000000000000000020000000000000000000000000000000000000000000000000000000000000000000
0000000000000000000000002000020000000000000000000000000000000000000000000000000000000000000000000
0000000000000000000000000000020000000000000000000000000000000000000000000000000000000000000000000
0000000000000000000020000000020000000000000000000000000000020000000000000000000000000000000000000
0000000000000000000000020000020000000000000000000000000000200000000000000000000000000000000000000
00000000000000000000000200*00200000000000000000002220502220000000000000000000*0000000000000000000
00000000000000000522222-2222220000000000000000002222250002000000000000000000020000000000000000000
0000000000000000050000000000000000000000000000*22222250002000000000000000000000000000000000000000
00000002-220200005000000000000022--22000000000222222250000000000000000000000000000000000000000000
0000002200002200050000000000002220022200000002222222250000000000000000000000000000000000000000000
0000022200002220050*00000000022220022220000022222222250000000000000000000000000000000000000000000
1111111111111111111111111111111111111111111111111111111111111111111111111111111111111111111111111